+-+-+-+-+-+-+-+-+
| |   |   | | | |
+ + + +-+ + + + +
| | |   |       |
+ + + +-+-+ +-+ +
|   |         | |
+-+-+ + + +-+ + +
| | | | |   | | |
+ + +-+-+ + +-+-+
| | | | | |     |
+ + + + + +-+-+ +
| | |     | | | |
+ + + +-+-+ + + +
| | | | | |   | |
+ + + + + + +-+ +
|             | |
+-+-+-+-+-+-+-+-+
