+-+-+-+-+-+-+-+-+-+-+-+
| |       |     | |   |
+ + + +-+ + + + + + + +
|   |   |   | | |   | |
+-+ + +-+ +-+-+-+ +-+-+
| | |   |     | |   | |
+ +-+ +-+-+ + + +-+ + +
|     | | | | |     | |
+ +-+ + + + +-+-+-+ + +
| | |     | |   |     |
+ + +-+-+-+ +-+ + +-+-+
|   | |     | |   |   |
+-+ + + + + + + + + + +
|     | | | |   |   | |
+ + +-+-+-+-+ + +-+ +-+
| | | | |   | | | |   |
+ +-+ + + + +-+ + +-+ +
|     | | |   |   | | |
+ + +-+ + + +-+-+ + + +
| | | | | | | | | |   |
+-+ + + + + + + + +-+ +
|         |         | |
+-+-+-+-+-+-+-+-+-+-+-+
