+-+-+-+-+-+-+-+-+-+-+-+
|   |     | | | | |   |
+-+ + +-+ + + + + +-+ +
| | | |     | | | | | |
+ + + +-+-+ + + + + + +
|   | | |         |   |
+-+ + + +-+ +-+-+-+-+ +
|     |           |   |
+-+-+ + +-+ +-+ +-+ + +
| | | |   | |   |   | |
+ + + + +-+ +-+ +-+ +-+
| | | |   |   | |   | |
+ + + +-+-+ + +-+-+ + +
| |       | |   | | | |
+ +-+-+ +-+ + +-+ + + +
|         | |         |
+-+-+-+-+-+-+-+-+-+-+-+
