+-+-+-+-+-+-+-+-+-+-+-+-+
| |     | | | |   |     |
+ +-+-+ + + + +-+ + +-+-+
| |         |           |
+ +-+-+ +-+-+-+-+ +-+-+-+
| |   |       | | | | | |
+ +-+ +-+-+ +-+ + + + + +
| |       | | | | |   | |
+ + +-+-+-+ + + + +-+ + +
|   |             | | | |
+ +-+-+ +-+-+-+-+-+ + + +
| |   | |   | |   |   | |
+ + +-+ + +-+ +-+ + +-+ +
|     | |     |   | | | |
+-+ +-+ +-+ +-+ +-+ + + +
| | | |   |   | | |     |
+ + + +-+ +-+ + + + +-+-+
|     |     |   | |     |
+-+ +-+-+-+ + +-+ + +-+-+
| |   | |   | |   | | | |
+ +-+ + +-+ + +-+ + + + +
|   | | |   |   | | | | |
+ +-+ + +-+ + +-+ + + + +
|                       |
+-+-+-+-+-+-+-+-+-+-+-+-+
